000000000
030050040
006207100
920000078
560040023
000000000
000608000
400502007
080000090
