682000045
000000000
000000009
000000800
504600000
000700010
060027000
030960024
705080000